NO ./assets/textures/north.xpm
SO ./assets/textures/south.xpm
WE ./assets/textures/west.xpm
EA ./assets/textures/east.xpm

F 96,84,58
C 130,170,210

111111
10N0N1
100001
111111
